NO ./img/wall_n.xpm
SO ./img/wall_s.xpm
WE ./img/wall_w.xpm
EA ./img/wall_e.xpm

C 1,0,0
F 	250,   33, 255



                1111111111111111111111111
                1111110111111111111111111
                1111111111111111111111111
                1001000000000000000000001
        111111111011000001110000000000001
        1000000000110000011101111111111111
        11110111111111011100000010001
        11110111111111011101010010001
        11000000110101011100001010001
        11111111111111111111111111111

        1111111111111111111111111111
        10000000000000001100000010001
        10000000000000001101010010001
        11000000110101011111011110N0111        1111
        11110111 1110101 101111010001          1001
        11111111 1111111 111111111111          1111
